0000000000000000000000000000000000000000
0000000000000000000000000000000000000000
0000000000000000000000000000000000000000
0000000000000000000000000000000000000000
0000000000000000000000000000000000000000
000000000000000000000000000000#####00000
000000000000000000000000000000#ddd#00000
000000000000000000000000000000#   #00000
0000000000000000000000#########   #00000
0000000000000000000000#           #00000
000#####00000000000000# #######   #00000
000#ddd#00000000000000# #00000#   #00000
000#   #00############# ####00#   #00000
000#   ####               l#00#   ###000
000#        #             l#00#    f#000
000#   ####               l#00#   ###000
000#   #00############# ####00#   #00000
000#   #00000000000000# #00000#   #00000
000#   #00000000000000# #######   #00000
000#   #00000000000000#       #   #00000
000### #00000000000000#######     #00000
000#   #00000000000000000000###   #00000
000# p #0000000000000000000000#uuu#00000
000#   #0000000000000000000000#####00000
000#####00000000000000000000000000000000
0000000000000000000000000000000000000000
0000000000000000000000000000000000000000
0000000000000000000000000000000000000000
0000000000000000000000000000000000000000
0000000000000000000000000000000000000000