0000000000000000000000000000000000000000
0000000000000000000000000000000000000000
0000000000000000000000000000000000000000
0000000000000000000000000000000000000000
0000000000000000000000000000000000000000
0000000000000000000000000000000000000000
0000000000000000000000000000000000000000
0000000000000000000000000000000000000000
0000000000000000000000000000000000000000
0000000000000000000000000000000000000000
0000000000000000000000000000000000000000
00000000000000000000000###00000000000000
0000000000000######0000#d#00000000000000
0000000000000#   p#0000# #00000000000000
0000000000000#  ###0000# #00000000000000
0000000000000#  l#00000# #00000000000000
000000000000##  #####00# #00000000000000
000000000000#r   ##d#### #####0000000000
000000000000##       #      l#0000000000
0000000000000#  r      l #f ##0000000000
0000000000000#uu     #   #  #00000000000
0000000000000######\/########00000000000
000000000000000000####000000000000000000
0000000000000000000000000000000000000000
0000000000000000000000000000000000000000
0000000000000000000000000000000000000000
0000000000000000000000000000000000000000
0000000000000000000000000000000000000000
0000000000000000000000000000000000000000
0000000000000000000000000000000000000000