0000000000000000000000000000000000000000
0000000000000000000000000000000000000000
000000000000000####000000000000000000000
00000000000#####d #000000000000000000000
000000######d ## d#000000000000000000000
000000#           #000000000000000000000
000#### ##        #000000000000000000000
000#      l#  uu  #000##############0000
000#      l# u #  l00#/     \  /\  /\#00
#### #ud#### dd#  #0#  #      //\\//\\#0
#r             r  ##   #      \\//\\//#0
#r             #  ##   #      //\\//\\ #
#####u###u##   #  l    ##     \\//\\// #
00000000000#   #  #   \d#     //\\//\\ #
00000000000#ud r        #     \\//\\// #
00000000000#d  #  #  d  #   \\//\\//\\ #
00000000000#   #u ## fl/#    \/  \/ //#0
00000000000#   ##u#0#  #/\/\/\/\/\/ /#00
00000000000r  #####00##  \/\/\/\/\/ #000
00000000000#  #   #000#   ##########0000
00000000000#  l   #000#   #0000000000000
00000000000#  #   #000#   #0000000000000
00000000000#  #####000#   #0000000000000
00000000000#   #000000#   #0000000000000
00000000000#   ########   #0000000000000
00000000000#              #0000000000000
00000000000#              #0000000000000
00000000000#            up#0000000000000
00000000000################0000000000000
0000000000000000000000000000000000000000