0000000000000000000000000000000000000000
0000000000000000000000000000000000000000
0000000000000000000000000000000000000000
0000000000000000000000000000000000000000
0000000000000000000000000000000000000000
0000000000000000000000000000000000000000
0000000000000000000000000000000000000000
0000000000000000000000000000000000000000
00000000000000000000###00000000000000000
0000000000000000#####d######000000000000
0000000000000000#dddd ddddd#000000000000
0000000000000####          #000000000000
0000000000000#f#p #     #  #000000000000
0000000000000# ##   # r    #000000000000
0000000000000# #/        l #000000000000
0000000000000# #\\u### #####000000000000
0000000000000#    r    #   #000000000000
0000000000000####          #000000000000
0000000000000000#          #000000000000
0000000000000000#uuuu  #####000000000000
0000000000000000#####uu#0000000000000000
0000000000000000000#####0000000000000000
0000000000000000000000000000000000000000
0000000000000000000000000000000000000000
0000000000000000000000000000000000000000
0000000000000000000000000000000000000000
0000000000000000000000000000000000000000
0000000000000000000000000000000000000000
0000000000000000000000000000000000000000
0000000000000000000000000000000000000000