00000000000000000000#0000000000000000000
0000000000000000000###000000000000000000
000000000000000000# # #00000000000000000
00000000000000000#  #  #0000000000000000
0000000000000000#   #   #000000000000000
000000000000000#    #    #00000000000000
00000000000000#dd   #     #0000000000000
00000000000000#  d  #     #0000000000000
00000000000000p   d #  #  #0000000000000
00000000000000#\    l  #  #0000000000000
00000000000000# \   #  #  #0000000000000
00000000000000#  \  #  #  #0000000000000
00000000000000#   \u#  #  #0000000000000
00000000000000#     #   # #0000000000000
00000000000000#     #   # #0000000000000
00000000000000#     #   ###0000000000000
00000000000000#     #uu   #0000000000000
0000000000########d#d###d ####0000000000
0000000000#r                l#0000000000
0000000000#r                l#0000000000
0000000000########u# #u#######0000000000
000000000000000000#   l00000000000000000
000000000000000000r   #00000000000000000
000000000000000000#   l00000000000000000
00000000000000000##   ##0000000000000000
00000000000000000#f    #0000000000000000
00000000000000000##   ##0000000000000000
000000000000000000#   #00000000000000000
000000000000000000#uuu#00000000000000000
000000000000000000#####00000000000000000