0000000000000000000000000000000000000000
0000000000000000000000000000000000000000
0000000000000000000000000000000000000000
0000000000000000000000000000000000000000
0000000000000000000000000000000000000000
0000000000000000000000000000000000000000
0000000000000000000000000000000000000000
0000000000000000000000000000000000000000
0000000000000000000000000000000000000000
000000000000000000########00000000000000
000000000000000000#/    \#00000000000000
000000000000000000# #### #00000000000000
000000000000####### #### #00000000000000
000000000000#           l###000000000000
000000000000# p        #  f#000000000000
000000000000#          #####000000000000
000000000000####### ####0000000000000000
000000000000000000# #0000000000000000000
000000000000000000#u#0000000000000000000
000000000000000000###0000000000000000000
0000000000000000000000000000000000000000
0000000000000000000000000000000000000000
0000000000000000000000000000000000000000
0000000000000000000000000000000000000000
0000000000000000000000000000000000000000
0000000000000000000000000000000000000000
0000000000000000000000000000000000000000
0000000000000000000000000000000000000000
0000000000000000000000000000000000000000
0000000000000000000000000000000000000000