0000000000000000000000000000000000000000
0000000000000000000000000000000000000000
0000000000000000000000000000000000000000
0000000000000000000000000000000000000000
0000000000000000000000000000000000000000
000000000000000000000000000##00000000000
00000000000000000000000000#dd#0000000000
0000000000000000000000000#d  d###0000000
0000000000000000#00##00##d      #0000000
000000000000000#d##dd##d     dd #0000000
00000000000000#d     d  d   /   #0000000
0000000000000#d       d    /    #0000000
0000000##00##d     \   d  /   u #0000000
000000#dd##d     dd \   d/   u  #0000000
00000#   d  d   /   f\      u   #0000000
00000#p   d    /      \    u    #0000000
000000#\   d  /   u#   \  u     #0000000
0000000#\   d/   u#     \u      #0000000
00000000#\      u#              #0000000
000000000#\    u#################0000000
0000000000#\  u#000000000000000000000000
00000000000#\u#0000000000000000000000000
000000000000##00000000000000000000000000
0000000000000000000000000000000000000000
0000000000000000000000000000000000000000
0000000000000000000000000000000000000000
0000000000000000000000000000000000000000
0000000000000000000000000000000000000000
0000000000000000000000000000000000000000
0000000000000000000000000000000000000000