0000000000000000000000000000000000000000
0000000000000000000000000000000000000000
0000000000000000000000000000000000000000
0000000000000000000000000000000000000000
0000000000000000000000000000000000000000
0000000000000000000000000000000000000000
0000000000000000000000000000000000000000
0000000000000000000000000000000000000000
00000000000#######0000000000000000000000
00000000000#/   \#0000000000000000000000
00000000000# ### ###00000000000000000000
00000000000# #0#\ \##0000000000000000000
00000000000# #0### f##000000000000000000
00000000000# #0###u l###0000000000000000
00000000000# #0##     l#0000000000000000
00000000000# #0#r     ##0000000000000000
00000000000# #0#### ####0000000000000000
00000000000# #0000# #0000000000000000000
00000000000# ###### #########00000000000
00000000000#\              l#00000000000
00000000000#######  #### ####00000000000
00000000000000000#uu#00# p#0000000000000
00000000000000000####00# ##0000000000000
00000000000000000000000#u#00000000000000
00000000000000000000000###00000000000000
0000000000000000000000000000000000000000
0000000000000000000000000000000000000000
0000000000000000000000000000000000000000
0000000000000000000000000000000000000000
0000000000000000000000000000000000000000