0000000000000000000000000000000000000000
0000000000000000000000000000000000000000
0000000000000000000000000000000000000000
0000000000000000000000000000000000000000
0000000000000000000000000000000000000000
0000000000000000000000000000000000000000
0000000000000000000000000000000000000000
00000000000000000000###00000000000000000
00000000000000000000#f#00000000000000000
0000000000000000#####u#####0000000000000
0000000000000000#/       \#0000000000000
0000000000000000# ##u u## #0000000000000
0000000000000000# ### ### #0000000000000
0000000000000000# ### ### #0000000000000
0000000000000000#\       l#0000000000000
0000000000000000#r       /#0000000000000
0000000000000000##### #####0000000000000
0000000000000######## ##0000000000000000
0000000000000#r        #0000000000000000
0000000000000#### ### ##0000000000000000
0000000000000000#p#0#u#00000000000000000
0000000000000000###0#u#00000000000000000
00000000000000000000###00000000000000000
0000000000000000000000000000000000000000
0000000000000000000000000000000000000000
0000000000000000000000000000000000000000
0000000000000000000000000000000000000000
0000000000000000000000000000000000000000
0000000000000000000000000000000000000000
0000000000000000000000000000000000000000