0000000000000000000000000000000000000000
0000000000000000000000000000000000000000
0000000000000000000000000000000000000000
0000000000000000000000000000000000000000
0000000000000000000000000000000000000000
0000000000000000000000000000000000000000
0000000000000000000000000000000000000000
0000000000000000000000000000000000000000
0000000000000000000000000000000000000000
000000000000000000######0000000000000000
000000000000000000#/  \#0000000000000000
000000000000000000#    #0000000000000000
000000000000000000#    ##000000000000000
000000000000000000#    p#000000000000000
000000000000000000# ## ##000000000000000
000000000000000000# ##u#0000000000000000
000000000000000000# ## #0000000000000000
000000000000000####u## ####0000000000000
000000000000000#fr /     l#0000000000000
000000000000000##\ / ######0000000000000
0000000000000000##   #000000000000000000
00000000000000000#####000000000000000000
0000000000000000000000000000000000000000
0000000000000000000000000000000000000000
0000000000000000000000000000000000000000
0000000000000000000000000000000000000000
0000000000000000000000000000000000000000
0000000000000000000000000000000000000000
0000000000000000000000000000000000000000
0000000000000000000000000000000000000000