0000000000000000000000000000000000000000
0000000000000000000000000000000000000000
0000000000000000000000000000000000000000
0000000000000000000000000000000000000000
0000000000000000000000000000000000000000
0000000000000000000000000000000000000000
0000000000000000000000000000000000000000
0000000000000000000000000000000000000000
0000000000000000000000000000000000000000
0000000000000000000000000000000000000000
0000000000####0000000####000000000000000
0000000000#dd#0000000#dd#000000000000000
0000000000#  #########  #######000000000
0000000000#        l##       l#000000000
0000000000#        l##       l#000000000
0000000000#  ###  ####  ##  ###000000000
0000000000#  #0#  #  #  ##    #000000000
0000000000#  #0#  ####  ##   f#000000000
0000000000#  #0#         l  ###000000000
0000000000## #0#         luu#00000000000
0000000000#p #0#  ###########00000000000
0000000000####0#uu#000000000000000000000
000000000000000####000000000000000000000
0000000000000000000000000000000000000000
0000000000000000000000000000000000000000
0000000000000000000000000000000000000000
0000000000000000000000000000000000000000
0000000000000000000000000000000000000000
0000000000000000000000000000000000000000
0000000000000000000000000000000000000000