0000000000000000000000000000000000000000
0000000000000000000000000000000000000000
0000000000000000000000000000000000000000
0000000000000000000000000000000000000000
0000000000000000000000000000000000000000
0000000000000000000000000000000000000000
0000000000000000000000000000000000000000
0000000000000000000000000000000000000000
0000000000000000000000000000000000000000
0000000000000000000000000000000000000000
00000000000000#############0000000000000
00000000000000#    # #    #0000000000000
00000000000000#    #      #0000000000000
00000000000000###### ######0000000000000
00000000000000#r         l#0000000000000
00000000000000#####  ######0000000000000
00000000000000#      #    #0000000000000
00000000000000# p  #    f #0000000000000
00000000000000#    #u#    #0000000000000
00000000000000#############0000000000000
0000000000000000000000000000000000000000
0000000000000000000000000000000000000000
0000000000000000000000000000000000000000
0000000000000000000000000000000000000000
0000000000000000000000000000000000000000
0000000000000000000000000000000000000000
0000000000000000000000000000000000000000
0000000000000000000000000000000000000000
0000000000000000000000000000000000000000
0000000000000000000000000000000000000000