0000000000000000000000000000000000000000
0000000000000000000000000000000000000000
0000000000000000000000000000000000000000
0000000000000000000000000000000000000000
0000000000000000000000000000000000000000
0000000000000000000000000000000000000000
0000000000000000000000000000000000000000
0000000000000000000####00000000000000000
0000000000000000000#dd#00000000000000000
0000000000000000000#  #00000000000000000
0000000000000000000#  #00000000000000000
0000000000000000000#  ####00000000000000
0000000000000000000#    f#00000000000000
0000000000000000000#  ####00000000000000
0000000000000000000#  #00000000000000000
0000000000000000000#  #00000000000000000
0000000000000000000#  #00000000000000000
0000000000000000000#  #00000000000000000
00000000000000000#### ##0000000000000000
00000000000000000#     #0000000000000000
00000000000000000# p   #0000000000000000
00000000000000000#     #0000000000000000
00000000000000000#######0000000000000000
0000000000000000000000000000000000000000
0000000000000000000000000000000000000000
0000000000000000000000000000000000000000
0000000000000000000000000000000000000000
0000000000000000000000000000000000000000
0000000000000000000000000000000000000000
0000000000000000000000000000000000000000