0000000000000000000000000000000000000000
0000000000000000000000000000000000000000
0000000000000000000000000000000000000000
0000000000000000000000000000000000000000
0000000000000000000000000000000000000000
0000000000000000000000000000000000000000
000000000000###############0000000000000
000000000000#             #0000000000000
000000000000# ########### ###00000000000
000000000000# #r           \#00000000000
000000000000# # ######### # #00000000000
000000000000# # #0000000#   #00000000000
0000000000### # ########### #00000000000
0000000000#   #\         \# #00000000000
0000000000# ###/         /# #00000000000
0000000000# ###\  \       l #00000000000
0000000000#   #### #####  l #00000000000
0000000000### #00#        # #00000000000
000000000000# #00#\   \#### #00000000000
000000000000# #00#  ## #### #00000000000
000000000000# #00#     p##fl#00000000000
000000000000# ###### # ######00000000000
000000000000#        #u#0000000000000000
000000000000############0000000000000000
0000000000000000000000000000000000000000
0000000000000000000000000000000000000000
0000000000000000000000000000000000000000
0000000000000000000000000000000000000000
0000000000000000000000000000000000000000
0000000000000000000000000000000000000000