0000000000000000000000000000000000000000
0000000000000000000000000000000000000000
0000000000000000000000000000000000000000
0000000000000000000000000000000000000000
0000000000000000######000000000000000000
0000000000000000#dddd#000000000000000000
0000000000000000#    #000000000000000000
0000000000000000#    ###0000000000000000
0000000000000000#     f#0000000000000000
0000000000000000#    ###0000000000000000
0000000000000000#    l#00000000000000000
000000000000000##    l#00000000000000000
000000000000000#r    ##00000000000000000
000000000000000##    ##00000000000000000
0000000000000000#    l#00000000000000000
0000000000000000#    l#00000000000000000
000000000000000##    l#00000000000000000
000000000000000#r    ##00000000000000000
000000000000000##    l#00000000000000000
000000000000000#r    ##00000000000000000
000000000000000##  uu#000000000000000000
000000000000000##    ###0000000000000000
000000000000000#  u    #0000000000000000
000000000000000#p      #0000000000000000
000000000000000#       #0000000000000000
000000000000000#########0000000000000000
0000000000000000000000000000000000000000
0000000000000000000000000000000000000000
0000000000000000000000000000000000000000
0000000000000000000000000000000000000000