0000000000000000000000000000000000000000
0000000000000000000000000000000000000000
0000000000000000000000000000000000000000
0000000000000000000000000000000000000000
0000000000000000000000000000000000000000
0000000000000000000000000000000000000000
0000000000000000000000000000000000000000
0000000000000000000000000000000000000000
0000000000000000000000000000000000000000
0000000000000000000###000000000000000000
00000000000000######d######0000000000000
00000000000000#    # #    #0000000000000
00000000000000#    # #    #0000000000000
00000000000000###### ######0000000000000
000000000000000#r       l#00000000000000
00000000000000#####  # ####0000000000000
00000000000000#      #    #0000000000000
00000000000000# f  # #    #0000000000000
00000000000000#    #u#  p #0000000000000
00000000000000#############0000000000000
0000000000000000000000000000000000000000
0000000000000000000000000000000000000000
0000000000000000000000000000000000000000
0000000000000000000000000000000000000000
0000000000000000000000000000000000000000
0000000000000000000000000000000000000000
0000000000000000000000000000000000000000
0000000000000000000000000000000000000000
0000000000000000000000000000000000000000
0000000000000000000000000000000000000000