0000000000000000000000000000000000000000
0000000000000000000000000000000000000000
0000000000000000000000000000000000000000
0000000000000000000000000000000000000000
0000000000000000000000000000000000000000
0000000000000000000000000000000000000000
0000000000000000000000000000000000000000
0000000000000000000000000000000000000000
0000000000000000000000000000000000000000
0000000000000000000000000000000000000000
000000000000###0000000000000000000000000
000000000000#f#0000000000000000000000000
000000000000# #############0000000000000
000000000000#  #          ##000000000000
000000000000#r       d    l#000000000000
000000000000#  #          ##000000000000
000000000000#  #### #     #0000000000000
000000000000#       #######0000000000000
000000000000#  ######0000000000000000000
000000000000# p#000000000000000000000000
000000000000####000000000000000000000000
0000000000000000000000000000000000000000
0000000000000000000000000000000000000000
0000000000000000000000000000000000000000
0000000000000000000000000000000000000000
0000000000000000000000000000000000000000
0000000000000000000000000000000000000000
0000000000000000000000000000000000000000
0000000000000000000000000000000000000000
0000000000000000000000000000000000000000