0000000000000000000000000000000000000000
0000000000000000000000000000000000000000
0000000000000000000000000000000000000000
00000000000000000000#######0000000000000
00000000000000000000#/  \d#0000000000000
00000000000000000000# ##  #####000000000
00000000000000000000# ##     l#000000000
00000000000000000000# ##  #p###000000000
00000000000000000000# ##  l##00000000000
00000000000000000000# ##  ##000000000000
00000000000000000000# #r  #0000000000000
00000000000000000000# ##  ##000000000000
00000000000000000000# ##  l#000000000000
00000000000000000000# ##  ##000000000000
00000000000000000000# #r  #0000000000000
00000000000########0# ##  ##000000000000
00000000000#      #0# ##  l#000000000000
00000000000#f ##  ### ##  ##000000000000
00000000000# #     l# #r  #0000000000000
00000000000#r   # ### ##  ##000000000000
00000000000#r  #  #0# ##  l#000000000000
00000000000##    l#0#\ r  ##000000000000
00000000000#r     #### #  #0000000000000
00000000000#####       #  #0000000000000
000000000000000#########uu#0000000000000
00000000000000000000000####0000000000000
0000000000000000000000000000000000000000
0000000000000000000000000000000000000000
0000000000000000000000000000000000000000
0000000000000000000000000000000000000000