0000000000000000000000000000000000000000
0000000000000000000000000000000000000000
0000000000000000000000000000000000000000
0000000000000000000000000000000000000000
0000000000000000000000000000000000000000
0000000000000000000000000000000000000000
000000000000000##############00000000000
000000000000000#/          \#00000000000
000000000000000# ########## #00000000000
000000000000000# #####0000# #00000000000
000000000000000#\   \##000# #00000000000
000000000000000##### f##00# #00000000000
0000000000000000####u l#### #00000000000
0000000000000000##       l# #00000000000
0000000000000000#r       ## #00000000000
0000000000000000##### ##### #00000000000
00000000000000000000# #000# #00000000000
00000000000########## ##### #00000000000
00000000000#r              /#00000000000
00000000000#### ####  #######00000000000
0000000000000#p #00#uu#00000000000000000
0000000000000## #00####00000000000000000
00000000000000#u#00000000000000000000000
00000000000000###00000000000000000000000
0000000000000000000000000000000000000000
0000000000000000000000000000000000000000
0000000000000000000000000000000000000000
0000000000000000000000000000000000000000
0000000000000000000000000000000000000000
0000000000000000000000000000000000000000