0000000000000000000000000000000000000000
0000000000000000000000000000000000000000
0000000000000000000000000000000000000000
0000000000000000000000000000000000000000
0000000000000000000000000000000000000000
0000000000000000000000000000000000000000
0000000000000000000000000000000000000000
0000000000000000000000000000000000000000
0000000000000000000###000000000000000000
0000000000000000000#d#000000000000000000
0000000000000000000# #000000000000000000
0000000000000000000# #000000000000000000
00000000000000000### #000000000000000000
00000000000000000#f  #####00000000000000
00000000000000000###    l#00000000000000
0000000000000000000# #####00000000000000
0000000000000000#### ##00000000000000000
0000000000000000#     #00000000000000000
0000000000000000#p    #00000000000000000
0000000000000000####u##00000000000000000
0000000000000000000###000000000000000000
0000000000000000000000000000000000000000
0000000000000000000000000000000000000000
0000000000000000000000000000000000000000
0000000000000000000000000000000000000000
0000000000000000000000000000000000000000
0000000000000000000000000000000000000000
0000000000000000000000000000000000000000
0000000000000000000000000000000000000000
0000000000000000000000000000000000000000