0000000000000000000000000000000000000000
0000000000000000000000000000000000000000
0000000000000000000000000000000000000000
0000000000000000000000000000000000000000
0000000000000000000000000000000000000000
0000000000000000000000000000000000000000
0000000000000000000000000000000000000000
0000000000000000000000000000000000000000
0000000000000000000000000000000000000000
000000000000000000###0000000000000000000
000000000000000000#f#0000000000000000000
000000000000000000# #0000000000000000000
000000000000#######u#######0000000000000
000000000000#             #0000000000000
000000000000# p           #0000000000000
000000000000#             #0000000000000
000000000000####### #######0000000000000
000000000000000000# #0000000000000000000
000000000000000000#u#0000000000000000000
000000000000000000###0000000000000000000
0000000000000000000000000000000000000000
0000000000000000000000000000000000000000
0000000000000000000000000000000000000000
0000000000000000000000000000000000000000
0000000000000000000000000000000000000000
0000000000000000000000000000000000000000
0000000000000000000000000000000000000000
0000000000000000000000000000000000000000
0000000000000000000000000000000000000000
0000000000000000000000000000000000000000