0000000000000000000000000000000000000000
0000000000000000000000000000000000000000
0000000000000000000000000000000000000000
0000000000000000000000000000000000000000
0000000000000000000000000000000000000000
0000000000000000000000000000000000000000
0000000000000000000000000000000000000000
0000000000000000000000000000000000000000
0000000000000000000000000000000000000000
0000000000000#############00000000000000
0000000000000#/         \#00000000000000
0000000000000#  #######  #00000000000000
0000000000000# ###    ## #00000000000000
0000000000000#   #     # #00000000000000
000000000000## # ####### ##0000000000000
000000000000#//      #    #0000000000000
000000000000#    ####     #0000000000000
000000000000#  ##p#f#     #0000000000000
000000000000#\       l  l #0000000000000
000000000000###############0000000000000
0000000000000000000000000000000000000000
0000000000000000000000000000000000000000
0000000000000000000000000000000000000000
0000000000000000000000000000000000000000
0000000000000000000000000000000000000000
0000000000000000000000000000000000000000
0000000000000000000000000000000000000000
0000000000000000000000000000000000000000
0000000000000000000000000000000000000000
0000000000000000000000000000000000000000