0000000000000000000000000000000000000000
0000000000000000000000000000000000000000
0000000000000000000000000000000000000000
0000000000000000000000000000000000000000
0000000000000000#######00000000000000000
0000000000000000#p    #00000000000000000
0000000000000000##    #00000000000000000
00000000000000000#    #00000000000000000
00000000000000000#    #00000000000000000
00000000000000000#    #00000000000000000
00000000000000000#    #00000000000000000
00000000000000000#    #00000000000000000
00000000000000000#    #00000000000000000
00000000000000000#    #00000000000000000
00000000000000000#    #00000000000000000
00000000000000000#    #00000000000000000
00000000000000000#    #00000000000000000
00000000000000000#    #00000000000000000
00000000000000000#    #00000000000000000
00000000000000000#    #00000000000000000
00000000000000####    ####00000000000000
00000000000000#      f   #00000000000000
00000000000000#          #00000000000000
00000000000000#   uuuu   #00000000000000
00000000000000############00000000000000
0000000000000000000000000000000000000000
0000000000000000000000000000000000000000
0000000000000000000000000000000000000000
0000000000000000000000000000000000000000
0000000000000000000000000000000000000000