0000000000000000000000000000000000000000
0000000000000000000000000000000000000000
0000000000000000000000000000000000000000
0000000000000000000000000000000000000000
0000000000000000000000000000000000000000
0000000000000000000000000000000000000000
0000000000000000000000000000000000000000
0000000000000000000000000000000000000000
0000000000000000000000000000000000000000
00000000000000000#####000000000000000000
00000000000000000#ddd#000000000000000000
00000000000000000#   #000000000000000000
00000000000000000#   ####000000000000000
00000000000000000#     f#000000000000000
00000000000000000#   ####000000000000000
00000000000000000#   #000000000000000000
00000000000000000#   #000000000000000000
00000000000000000#   #000000000000000000
00000000000000000#   #000000000000000000
000000000000000###   ###0000000000000000
000000000000000# p     #0000000000000000
000000000000000#       #0000000000000000
000000000000000#       #0000000000000000
000000000000000#########0000000000000000
0000000000000000000000000000000000000000
0000000000000000000000000000000000000000
0000000000000000000000000000000000000000
0000000000000000000000000000000000000000
0000000000000000000000000000000000000000
0000000000000000000000000000000000000000