0000000000000000000000000000000000000000
0000000000000000000000000000000000000000
0000000000000000000000000000000000000000
0000000000000000000000000000000000000000
0000000000000000000000000000000000000000
0000000000000000000000000000000000000000
0000000000000000000000000000000000000000
0000000000000000000000000000000000000000
00000000000000000000#######0000000000000
00000000000000000000#     #0000000000000
00000000000000000000#  p  #0000000000000
00000000000000000000# ### #0000000000000
00000000000000000000#     #0000000000000
00000000000000000000##r  ##0000000000000
000000000000000000000#r  ###000000000000
000000000000000000000##    #000000000000
000000000000000000000#   ###000000000000
000000000000000000000### #00000000000000
0000000000000000######## #00000000000000
0000000000000000#    ### #00000000000000
0000000000000000#f       #00000000000000
0000000000000000#    ###u#00000000000000
0000000000000000######0###00000000000000
0000000000000000000000000000000000000000
0000000000000000000000000000000000000000
0000000000000000000000000000000000000000
0000000000000000000000000000000000000000
0000000000000000000000000000000000000000
0000000000000000000000000000000000000000
0000000000000000000000000000000000000000