0000000000000000000000000000000000000000
0000000000000000000000000000000000000000
0000000000000000000000000000000000000000
0000000000000000000000000000000000000000
0000000000000000000000000000000000000000
0000000000000000000000000000000000000000
000000000000000###########00000000000000
000000000000000#/       \#00000000000000
00000000000##### ####### #####0000000000
00000000000#/           / \  #0000000000
00000000000# ### ######      #0000000000
00000000000#       lr   / \ \#0000000000
00000000000# ### ######p     #0000000000
00000000000# ### #000#/ / \ /#0000000000
00000000000# ### #00##       #0000000000
00000000000#  ##u#000#\ / \ \#0000000000
00000000000#\u   #000#       #0000000000
00000000000##### #000#/ / \ /#0000000000
000000000000000# #000#       #0000000000
000000000000000# #000#\ / \ \#0000000000
000000000000000# ########### ##000000000
000000000000000#            lf#000000000
000000000000000################000000000
0000000000000000000000000000000000000000
0000000000000000000000000000000000000000
0000000000000000000000000000000000000000
0000000000000000000000000000000000000000
0000000000000000000000000000000000000000
0000000000000000000000000000000000000000
0000000000000000000000000000000000000000