0000000000000000000000000000000000000000
0000000000000000000000000000000000000000
0000000000000000000000000000000000000000
0000000000000000000000000000000000000000
0000000000000000000000000000000000000000
0000000000000000000000000000000000000000
0000000000000000000000000000000000000000
0000000000000000000000000000000000000000
0000000000000000##############0000000000
0000000000000000#/          \#0000000000
0000000000000000# ########## #0000000000
0000000000000000# #####0000# #0000000000
0000000000000000#\   \##000# #0000000000
0000000000000000##### f##00# #0000000000
00000000000000000####u l#### #0000000000
00000000000000000###    l### #0000000000
00000000000000000###r    ### #0000000000
00000000000000000##### ##### #0000000000
000000000000000000000# #   # #0000000000
000000000000########## ##### #0000000000
000000000000#r              /#0000000000
000000000000####p##### #######0000000000
000000000000000###000#u#0000000000000000
000000000000000000000###0000000000000000
0000000000000000000000000000000000000000
0000000000000000000000000000000000000000
0000000000000000000000000000000000000000
0000000000000000000000000000000000000000
0000000000000000000000000000000000000000
0000000000000000000000000000000000000000