0000000000000000000000000000000000000000
0000000000000000000000000000000000000000
0000000000000000000000000000000000000000
0000000000000000000000000000000000000000
0000000000000000000000000000000000000000
0000000000000000000000000000000000000000
0000000000000000000000000000000000000000
0000000000000000000000000000000000000000
0000000000000000000000000000000000000000
000000000000000000######0000000000000000
000000000000000000#f d #0000000000000000
000000000000000000#   d#0000000000000000
000000000000000000#    #0000000000000000
000000000000000000#    #0000000000000000
000000000000000000#dd  #0000000000000000
000000000000000000#    #0000000000000000
00000000000000000##    #0000000000000000
00000000000000000#p    #0000000000000000
00000000000000000##    #0000000000000000
000000000000000000######0000000000000000
0000000000000000000000000000000000000000
0000000000000000000000000000000000000000
0000000000000000000000000000000000000000
0000000000000000000000000000000000000000
0000000000000000000000000000000000000000
0000000000000000000000000000000000000000
0000000000000000000000000000000000000000
0000000000000000000000000000000000000000
0000000000000000000000000000000000000000
0000000000000000000000000000000000000000